###############################
S        #     #              #
####  #  #  ################  #
#     #     #           #     #
####  #  #  ####  #  #  ####  #
#     #  #     #  #  #  #     #
#######  ####  ####  ####  ####
#     #  #     #              #
####  #######  #  #  ####  ####
#     #        #  #  #        #
#  ####  #  #  #######  #######
#        #  #                 #
#  ##########  #  #  ##########
#  #  #     #  #  #  #     #  #
####  #  #######  #  ####  #  #
#     #           #  #  #     #
####  ##########  ####  ####  #
#  #  #  #              #     #
#  #  #  #######  ####  #  #  #
#                 #        #  E
###############################
