######S###
#   #    #
#        #
# ########
#      ###
#####   ##
#   ###  #
#        #
#E########
