#S########
#   #    #
###   ####
#   #    #
######## #
#        #
###   ####
#   #    #
#E########

