##S#######
#        #
#    #####
#        #
#        #
####     #
#        #
#        #
##E#######