##S#######
#  #     #
#  #   ###
#  # #   #
#    #   #
######   #
#        #
#   #    #
##E#######
