#########################################################################
#               #                                                       #
#       #       #     #     #############################################
#       #       #     #                                                 #
#       #       #     ################################################  #
#       #       #     #                                                 #
#       #       #     #   ###############################################
#       #       #     #                                                 #
#       #       #     ################################################  #
#       #       #     #                                                 #
#       #       #     #   ###############################################
#       #       #     #                                                 #
#       #             #                                                 S
###E#####################################################################
