##S########################################################################################
#        #     #        #        #                 #  #        #        #  #  #           #
#  ####  ####  #  #  #  #######  #  #  #######  ####  #  ####  ####  ####  #  ####  ####  #
#  #  #        #  #  #              #     #        #        #     #        #  #     #     #
#  #  #  #  ####  #  #######  #  #  #######  #  ################  #######  #  #  ##########
#     #  #        #        #  #  #  #        #           #  #     #     #     #  #        #
###################  ####  #############  #  #  ####  #  #  ####  ####  #  ####  ####  ####
#        #  #     #     #  #           #  #  #  #     #  #              #     #        #  #
#######  #  #  ####  ##########  ####  #############  #############  ####  #######  ####  #
#              #  #     #     #     #  #  #     #     #     #     #                 #     #
####  ####  ####  ####  #  #######  ####  #  ####  #######  #  ####  ################  #  #
#     #  #              #                 #  #  #  #        #     #        #     #     #  #
#  ####  #  ################  ####  #######  #  #  #  #######  #  #  #  #  ####  #  ####  #
#     #     #        #  #  #     #              #     #  #     #     #  #  #        #     #
#  #######  #  ####  #  #  ####  ####  ##########  #  #  #  #  #  #######  #############  #
#     #        #           #     #     #        #  #     #  #  #     #  #  #              #
##########  ####  #  #  ##########  #  ####  ##########  ##########  #  #  ####  #  #  ####
#     #        #  #  #              #  #     #        #     #           #  #     #  #     #
#  ####  #######  ################  #  #  #  #  ####  ##########  #  ##########  #  ####  #
#     #        #  #              #  #  #  #        #  #        #  #  #  #  #  #  #  #     #
#  ####  #  #  ####  #######  #######  #  #######  #######  ####  ####  #  #  #######  #  #
#     #  #  #  #  #  #     #  #  #        #        #  #           #              #     #  #
#  ####  ####  #  ####  #  #  #  #  #######  ####  #  #  #  ####  ####  #######  #######  #
#  #  #  #  #  #  #     #  #     #  #  #     #  #  #  #  #  #  #  #     #        #        #
#  #  #  #  #  #  #  ####  ####  ####  #  #  #  #  #  ####  #  ################  ####  ####
#        #        #  #  #  #              #  #        #     #     #     #     #     #  #  #
##########  #######  #  #  #######  ####  #######  #  #  ####  #  #  #  #  ####  #  #  #  #
#     #        #        #  #        #        #  #  #     #     #  #  #     #     #  #  #  #
####  ####  #  #  #  ##########  ####  #######  #  ####  #######  ####  ####  ####  #  #  #
#  #  #     #  #  #  #     #  #     #  #     #     #  #                       #           #
#  #  ##########  #######  #  #  ##########  #######  ####  #  #  #  #  ####  #  ##########
#           #  #     #     #  #     #        #              #  #  #  #     #  #  #        #
##########  #  ####  #  #  #  ####  ####  #############  ####  #######  #  ####  #  #  #  #
#  #     #  #        #  #           #           #     #     #  #     #  #  #     #  #  #  #
#  ####  #  #  ####  #  #  #  ##########  #  ####  ################  ####  #######  ####  #
#     #     #  #        #  #        #  #  #                 #     #  #              #     #
#  ####  #  ####  #  ##########  ####  ##########  #  ##########  #  #  #  ####  ##########
#        #  #     #     #     #  #     #  #  #     #     #     #  #     #     #  #  #     #
####  #############  #  ####  #  ####  #  #  #  ####  #  #  #  #  #  #  #######  #  ####  #
#        #  #        #     #        #        #  #  #  #  #  #        #  #           #     #
#  ####  #  ####  #  ###################  #######  #  #######  ####  ##########  #######  #
#  #  #     #  #  #                 #                    #     #  #  #        #           #
####  #  ####  ####  #  ####  #  ####  ####  #  #  ####  #  ####  ####  ##########  #  #  #
#                 #  #     #  #     #     #  #  #  #           #     #        #     #  #  #
#  ####  #############  #######  #######  ####  ####  ####  ####  #  #######  #  #  #######
#  #  #     #     #  #        #  #     #     #  #     #     #     #        #     #        #
#  #  #  #  #  #  #  ##########  ####  #  #############  #  #######  #############  #######
#  #     #     #        #        #        #  #     #     #     #              #           #
#  #######  ####  ##########  #######  #  #  #  #  #  #  ####  ####  #######  #######  ####
#     #     #        #     #  #     #  #     #  #     #  #  #  #     #           #  #     #
####  ####  #  #  #  #  #######  #######  ##########  ####  #######  #  ####  #  #  #  ####
#     #     #  #  #  #  #  #     #     #     #           #  #        #  #     #  #        #
#######  #  #  #######  #  #  #######  #  ##########  #  #  #######  #  ####  ####  #######
#  #     #  #     #           #        #  #     #  #  #     #        #  #     #           #
#  #######  #  ####  ####  #  #######  ####  #  #  #  #  ##########  ####  #  #  #  #######
#     #  #  #  #        #  #           #     #  #  #  #  #  #  #        #  #  #  #        #
#  ####  #  ##########  #  ####  ##########  #  #  #  #  #  #  #############  #  #  #  ####
#  #     #        #     #     #     #        #        #     #        #        #  #  #  #  #
#  #  #######  #  #######  #  #  ####  #  ####  ##########  #  #  ####  ####  #######  #  #
#              #           #  #        #  #              #     #           #        #     E
###########################################################################################
